4 2 1 200 200 100 5 500 350 20
9 2 1 800 500 100 2 200 500 100
8 4 1 200 500 100 1 800 500 100 2 200 200 100 2 800 200 100

8 0
12 2 2 500 200 100 2 500 500 100
7 3 1 200 200 100 1 800 200 100 3 500 350 100
7 3 3 500 200 100 3 500 500 100 4 200 350 50
9 4 4 200 200 50 4 800 200 50 4 200 500 50 3 800 500 100
10 4 1 800 200 100 2 200 200 100 3 200 500 100 3 800 500 100
14 1 1 800 200 100
9 2 2 200 500 100 4 800 200 50

78 0
3 2 1 200 200 100 5 800 500 200
2 4 2 200 200 100 2 800 200 100 2 200 500 100 2 800 500 100
2 2 5 500 200 200 7 500 350 20
12 3 1 800 200 100 1 800 500 100 4 200 350 50
3 3 5 200 200 200 5 800 200 200 3 500 350 100



6 0
5 0
1 0